Model Adaptor

This model description is not a real EMF artifact. It was generated by the
org.eclipse.emf.examples.generator.validator plug-in to illustrate how EMF's
code generator can be extended.
This can be disabled with -vmargs -Dorg.eclipse.emf.examples.generator.validator=false.

Package adaptor <http://adaptor>

  Class Adaptor -> Named
    Reference matching : Matching<<0..*>>
    Reference eltGraph : Indiagram<<0..*>>

  Class Matching
    Reference correspondanceRule : CorrespondanceRule<<0..*>>
    Reference composed : Instance<<0..*>>
    Reference lhs : LhsPattern<<1..1>>
    Reference rhs : RhsPattern<<0..*>>

  Class Pattern
    Reference composed : Instance<<0..*>>
    Reference query : Query

  Class Instance -> Named, Indiagram
    Reference concept : EClass
    Attribute isMain : EBoolean

  Class CorrespondanceRule
    Reference feature : EStructuralFeature
    Reference property : Property<<1..1>>

  Class Property -> Indiagram
    Reference setPart : Action
    Reference getPart : Query<<1..1>>

  Class Query
    Reference request : Request<<1..1>>

  Class Action
    Reference request : Request<<1..1>>

  Class Named
    Attribute name : EString

  Class LhsPattern -> Pattern

  Class RhsPattern -> Pattern

  Class Request -> Indiagram
    Attribute expression : EString
    Attribute langage : Langage

  Class Indiagram

  Enum Langage
    Literal Java = 0
